{
	"lobby" : [
		"#############..#############",
		"#############..#############",
		"##........................##",
		"##.ll..................ll.##",
		"##.ll..................ll.##",
		"##........................##",
		"##...............o........##",
		"............................",
		".................l..........",
		"##...X....................##",
		"##........................##",
		"##.ll..........@.......ll.##",
		"##.ll..................ll.##",
		"##........................##",
		"#############..#############",
		"#############..#############"
	],
	"0" : [
		"#############..#############",
		"#############..#############",
		"##.........l....l.........##",
		"##@..................X...@##",
		"##...@@@............@@@...##",
		"##........................##",
		"##..l......@@@@@@......l..##",
		"..........@.X..@@...........",
		"..........@....@.........@..",
		"##..l.....@....@.......l..##",
		"##........................##",
		"##...@@@............@@@...##",
		"##@....X.................@##",
		"##.........l....l.........##",
		"#############..#############",
		"#############..#############"
	]
}
