{
	"lobby" : [
		"#############..#############",
		"#############..#############",
		"##........................##",
		"##........................##",
		"##........................##",
		"##................@@......##",
		"##........................##",
		"##........................##",
		"............................",
		"............................",
		"##.............@..........##",
		"##........................##",
		"##........................##",
		"##........................##",
		"##........................##",
		"#############..#############",
		"#############..#############"
	],
	"0" : [
		"#############..#############", 
		"#############..#############",
		"##..............#.........##",
		"##..............#.........##",
		"##........................##",
		"##................@@......##",
		"##.........@@@@...........##",
		"##........................##",
		"............................",
		"............................",
		"##.............@..........##",
		"##........................##",
		"##........................##",
		"##........................##",
		"##........................##",
		"#############..#############",
		"#############..#############"
	],
	"1" : [
		"#############..#############", 
		"#############..#############",
		"##..............#.........##",
		"##..............#.........##",
		"##........................##",
		"##................@@......##",
		"##.........@@@@...........##",
		"##........................##",
		"............@@@@@@@@........",
		"............................",
		"##.............@..........##",
		"##........................##",
		"##........................##",
		"##........................##",
		"##........................##",
		"#############..#############",
		"#############..#############"
	]
}
